#####################
.....................
####.................
#################....
.........#########...
........#########....
##.......#####.....##
####.............####
#######.....#########
#####################