########################
.....................###
####..................##
#################......#
.........#########.....#
........#########.....##
##.......#####.....#####
####.............#######
#######.....############
########################