############################################################
######......################################################
####.......######.......................####################
#####.......................................################
#######.....###############......................###########
####################################..................######
########......###############################..........#####
######...............#############.................##...####
######.......######.....................############....####
#########.....####################################....######
###########............#######################.....#########
###################.......#################......###########
#######....................##################...############
#####........................#################.....#########
########...................######################.....######
####....................############################....####
######................#########################.........####
###########...###########################.......############
###########...################....................##########
##########....#####.....##################..........########
########....#######......########################......#####
######....##########....####################################
####....########################......######################
####......###################...........####################
########......##........######...........###################
###########...............############..........############
######################.........#########.......#############
######################.......................###############
############################...............#################
############################################################