####################
##.....#############
##....##############
####################
####################
####################
###########.########
#############.######
####################
####################