########################################################################################################################
########################################################################################################################
######################...................###############################################################################   
##################...........................###########################################################################
##############..................................########################################################################
#############......................................#####################################################################
##############...................................#######################################################################
##################.........................#############################################################################
###########.................................############################################################################
########################......##########################################################################################
#########################......#########################################################################################
########################......##########################################################################################
#######################......###########################################################################################
#####################......#####################..................######################################################
#####################......#################........................####################################################
###########....................############.............................################################################
#########......................###########..........................####################################################
##########.........................................................#####################################################   
########################################################################################################################
########################################################################################################################
########################################################################################################################
########################################################################################################################
########################################################################################################################
########################################################################################################################
########################################################################################################################
########################################################################################################################
########################################################################################################################
########################################################################################################################
########################################################################################################################
########################################################################################################################