#########################
....####....#######....##
##........######........#
####................#####
##....................###
#####....................
########.................
####..................###
#######...........#######
#.........###############
#........################
####...##################
#########################